10 10 10 10 10 10 10 10 10 10 10 10 10 10 10 10 10 10 10
10 10 10 10 10 10 10 10 10 10 10 10 10 10 10 10 10 10 10
19 11 11 11 11 11 11 11 11 21 11 11 11 11 11 11 11 11 17
12 10 10 10 10 10 10 10 10 12 10 10 10 10 10 10 10 10 12
12 10 19 17 10 19 11 17 10 12 10 19 11 17 10 19 17 10 12
12 10 18 20 10 18 11 20 10 13 10 18 11 20 10 18 20 10 12
12 10 10 10 10 10 10 10 10 10 10 10 10 10 10 10 10 10 12
12 10 14 15 10 16 10 14 11 21 11 15 10 16 10 14 15 10 12
12 10 10 10 10 12 10 10 10 12 10 10 10 12 10 10 10 10 12
24 11 11 17 10 24 11 15 10 13 10 14 11 23 10 19 11 11 23
12 10 10 12 10 12 10 10 10 10 10 10 10 12 10 12 10 10 12
22 11 11 20 10 13 10 19 11 11 11 17 10 13 10 18 11 11 22
10 10 10 10 10 10 10 12 10 10 10 12 10 10 10 10 10 10 10
21 11 11 17 10 16 10 18 11 11 11 20 10 16 10 19 11 11 21
12 10 10 12 10 12 10 10 10 10 10 10 10 12 10 12 10 10 12
24 11 11 20 10 13 10 14 11 21 11 15 10 13 10 18 11 11 23
12 10 10 10 10 10 10 10 10 12 10 10 10 10 10 10 10 10 12
12 10 14 17 10 14 11 15 10 13 10 14 11 15 10 19 15 10 12
12 10 10 12 10 10 10 10 10 10 10 10 10 10 10 12 10 10 12
24 15 10 13 10 16 10 14 11 21 11 15 10 16 10 13 10 14 23
12 10 10 10 10 12 10 10 10 12 10 10 10 12 10 10 10 10 12
12 10 14 11 11 22 11 15 10 13 10 14 11 22 11 11 15 10 12
12 10 10 10 10 10 10 10 10 10 10 10 10 10 10 10 10 10 12
18 11 11 11 11 11 11 11 11 11 11 11 11 11 11 11 11 11 20